aa	 aa
aai	 aai
aau	 aau
aam	 aam
aan	 aan
aang	 aang
aap	 aap
aat	 aat
aak	 aak
ai	 ai
au	 au
am	 am
ang	 ang
ap	 ap
ak	 ak
e	 e
ei	 ei
o	 o
oi	 oi
ou	 ou
on	 on
ong	 ong
ok	 ok
ung	 ung
uk	 uk
baa	b aa
baai	b aai
baau	b aau
baan	b aan
baang	b aang
baat	b aat
baak	b aak
bai	b ai
bau	b au
bam	b am
ban	b an
bang	b ang
bat	b at
bak	b ak
be	b e
bei	b ei
beng	b eng
bek	b ek
biu	b iu
bin	b in
bing	b ing
bit	b it
bik	b ik
bo	b o
bou	b ou
bong	b ong
bok	b ok
bui	b ui
bun	b un
bung	b ung
but	b ut
buk	b uk
paa	p aa
paai	p aai
paau	p aau
paan	p aan
paang	p aang
paak	p aak
pai	p ai
pau	p au
pan	p an
pang	p ang
pat	p at
pei	p ei
peng	p eng
pek	p ek
piu	p iu
pin	p in
ping	p ing
pit	p it
pik	p ik
po	p o
poi	p oi
pou	p ou
pong	p ong
pok	p ok
pui	p ui
pun	p un
pung	p ung
put	p ut
puk	p uk
maa	m aa
maai	m aai
maau	m aau
maan	m aan
maang	m aang
maat	m aat
maak	m aak
mai	m ai
mau	m au
man	m an
mang	m ang
mat	m at
mak	m ak
me	m e
mei	m ei
meng	m eng
mi	m i
miu	m iu
min	m in
ming	m ing
mit	m it
mik	m ik
mo	m o
mou	m ou
mong	m ong
mok	m ok
mui	m ui
mun	m un
mung	m ung
mut	m ut
muk	m uk
faa	f aa
faai	f aai
faan	f aan
faat	f aat
faak	f aak
fai	f ai
fau	f au
fan	f an
fang	f ang
fat	f at
fe	f e
fei	f ei
fiu	f iu
fo	f o
fong	f ong
fok	f ok
fu	f u
fui	f ui
fun	f un
fung	f ung
fut	f ut
fuk	f uk
daa	d aa
daai	d aai
daam	d aam
daan	d aan
daap	d aap
daat	d aat
daak	d aak
dai	d ai
dau	d au
dam	d am
dan	d an
dang	d ang
dap	d ap
dat	d at
dak	d ak
de	d e
dei	d ei
deu	d eu
deng	d eng
dek	d ek
di	d i
diu	d iu
dim	d im
din	d in
ding	d ing
dip	d ip
dit	d it
dik	d ik
do	d o
doi	d oi
dou	d ou
dong	d ong
dok	d ok
doe	d oe
doek	d oek
deoi	d eoi
deon	d eon
deot	d eot
dung	d ung
duk	d uk
dyun	d yun
dyut	d yut
taa	t aa
taai	t aai
taam	t aam
taan	t aan
taap	t aap
taat	t aat
tai	t ai
tau	t au
tam	t am
tan	t an
tang	t ang
teng	t eng
tek	t ek
tiu	t iu
tim	t im
tin	t in
ting	t ing
tip	t ip
tit	t it
tik	t ik
to	t o
toi	t oi
tou	t ou
tong	t ong
tok	t ok
toe	t oe
teoi	t eoi
teon	t eon
tung	t ung
tuk	t uk
tyun	t yun
tyut	t yut
naa	n aa
naai	n aai
naau	n aau
naam	n aam
naan	n aan
naap	n aap
naat	n aat
nai	n ai
nau	n au
nam	n am
nan	n an
nang	n ang
nap	n ap
nat	n at
nak	n ak
ne	n e
nei	n ei
ni	n i
niu	n iu
nim	n im
nin	n in
ning	n ing
nip	n ip
nik	n ik
no	n o
noi	n oi
nou	n ou
nong	n ong
nok	n ok
noeng	n oeng
neoi	n eoi
neot	n eot
nung	n ung
nuk	n uk
nyun	n yun
laa	l aa
laai	l aai
laau	l aau
laam	l aam
laan	l aan
laang	l aang
laap	l aap
laat	l aat
laak	l aak
lai	l ai
lau	l au
lam	l am
lang	l ang
lap	l ap
lat	l at
lak	l ak
le	l e
lei	l ei
lem	l em
leng	l eng
lek	l ek
li	l i
liu	l iu
lim	l im
lin	l in
ling	l ing
lip	l ip
lit	l it
lik	l ik
lo	l o
loi	l oi
lou	l ou
long	l ong
lok	l ok
loeng	l oeng
loek	l oek
leoi	l eoi
leon	l eon
leot	l eot
lung	l ung
luk	l uk
lyun	l yun
lyut	l yut
gaa	g aa
gaai	g aai
gaau	g aau
gaam	g aam
gaan	g aan
gaang	g aang
gaap	g aap
gaat	g aat
gaak	g aak
gai	g ai
gau	g au
gam	g am
gan	g an
gang	g ang
gap	g ap
gat	g at
ge	g e
gei	g ei
geng	g eng
gep	g ep
giu	g iu
gim	g im
gin	g in
ging	g ing
gip	g ip
git	g it
gik	g ik
go	g o
goi	g oi
gou	g ou
gon	g on
gong	g ong
got	g ot
gok	g ok
goe	g oe
goeng	g oeng
goek	g oek
geoi	g eoi
gu	g u
gun	g un
gung	g ung
guk	g uk
gyun	g yun
gyut	g yut
kaa	k aa
kaai	k aai
kaau	k aau
kaat	k aat
kaak	k aak
kai	k ai
kau	k au
kam	k am
kan	k an
kang	k ang
kap	k ap
kat	k at
ke	k e
kei	k ei
kek	k ek
kiu	k iu
kim	k im
kin	k in
king	k ing
kit	k it
kik	k ik
ko	k o
koi	k oi
kong	k ong
kok	k ok
koe	k oe
koeng	k oeng
koek	k oek
keoi	k eoi
ku	k u
kui	k ui
kung	k ung
kut	k ut
kuk	k uk
kyun	k yun
kyut	k yut
ngaa	ng aa
ngaai	ng aai
ngaau	ng aau
ngaam	ng aam
ngaan	ng aan
ngaang	ng aang
ngaap	ng aap
ngaat	ng aat
ngaak	ng aak
ngai	ng ai
ngau	ng au
ngam	ng am
ngan	ng an
ngang	ng ang
ngap	ng ap
ngat	ng at
ngak	ng ak
ngit	ng it
ngo	ng o
ngoi	ng oi
ngou	ng ou
ngon	ng on
ngong	ng ong
ngok	ng ok
ngung	ng ung
nguk	ng uk
haa	h aa
haai	h aai
haau	h aau
haam	h aam
haan	h aan
haang	h aang
haap	h aap
haak	h aak
hai	h ai
hau	h au
ham	h am
han	h an
hang	h ang
hap	h ap
hat	h at
hak	h ak
hei	h ei
heng	h eng
hek	h ek
hiu	h iu
him	h im
hin	h in
hing	h ing
hip	h ip
hit	h it
hik	h ik
ho	h o
hoi	h oi
hou	h ou
hon	h on
hong	h ong
hot	h ot
hok	h ok
hoe	h oe
hoeng	h oeng
heoi	h eoi
hung	h ung
huk	h uk
hyun	h yun
hyut	h yut
gwaa	gw aa
gwaai	gw aai
gwaan	gw aan
gwaang	gw aang
gwaat	gw aat
gwaak	gw aak
gwai	gw ai
gwan	gw an
gwang	gw ang
gwat	gw at
gwing	gw ing
gwik	gw ik
gwo	gw o
gwong	gw ong
gwok	gw ok
kwaa	kw aa
kwaai	kw aai
kwaang	kw aang
kwai	kw ai
kwan	kw an
kwik	kw ik
kwong	kw ong
kwok	kw ok
waa	w aa
waai	w aai
waan	w aan
waang	w aang
waat	w aat
waak	w aak
wai	w ai
wan	w an
wang	w ang
wat	w at
wing	w ing
wik	w ik
wo	w o
wong	w ong
wok	w ok
wu	w u
wui	w ui
wun	w un
wut	w ut
zaa	z aa
zaai	z aai
zaau	z aau
zaam	z aam
zaan	z aan
zaang	z aang
zaap	z aap
zaat	z aat
zaak	z aak
zai	z ai
zau	z au
zam	z am
zan	z an
zang	z ang
zap	z ap
zat	z at
zak	z ak
ze	z e
zeng	z eng
zek	z ek
zi	z i
ziu	z iu
zim	z im
zin	z in
zing	z ing
zip	z ip
zit	z it
zik	z ik
zo	z o
zoi	z oi
zou	z ou
zong	z ong
zok	z ok
zoeng	z oeng
zoek	z oek
zeoi	z eoi
zeon	z eon
zeot	z eot
zung	z ung
zuk	z uk
zyu	z yu
zyun	z yun
zyut	z yut
caa	c aa
caai	c aai
caau	c aau
caam	c aam
caan	c aan
caang	c aang
caap	c aap
caat	c aat
caak	c aak
cai	c ai
cau	c au
cam	c am
can	c an
cang	c ang
cap	c ap
cat	c at
cak	c ak
ce	c e
ceng	c eng
cek	c ek
ci	c i
ciu	c iu
cim	c im
cin	c in
cing	c ing
cip	c ip
cit	c it
cik	c ik
co	c o
coi	c oi
cou	c ou
cong	c ong
cok	c ok
coeng	c oeng
coek	c oek
ceoi	c eoi
ceon	c eon
ceot	c eot
cun	c un
cung	c ung
cuk	c uk
cyu	c yu
cyun	c yun
cyut	c yut
saa	s aa
saai	s aai
saau	s aau
saam	s aam
saan	s aan
saang	s aang
saap	s aap
saat	s aat
saak	s aak
sai	s ai
sau	s au
sam	s am
san	s an
sang	s ang
sap	s ap
sat	s at
sak	s ak
se	s e
sei	s ei
seng	s eng
sek	s ek
si	s i
siu	s iu
sim	s im
sin	s in
sing	s ing
sip	s ip
sit	s it
sik	s ik
so	s o
soi	s oi
sou	s ou
song	s ong
sok	s ok
soeng	s oeng
soek	s oek
seoi	s eoi
seon	s eon
seot	s eot
sung	s ung
suk	s uk
syu	s yu
syun	s yun
syut	s yut
jaa	j aa
jaai	j aai
jaak	j aak
jai	j ai
jau	j au
jam	j am
jan	j an
jap	j ap
jat	j at
je	j e
jeng	j eng
ji	j i
jiu	j iu
jim	j im
jin	j in
jing	j ing
jip	j ip
jit	j it
jik	j ik
jo	j o
joeng	j oeng
joek	j oek
jeoi	j eoi
jeon	j eon
jung	j ung
juk	j uk
jyu	j yu
jyun	j yun
jyut	j yut
